XXXXXXXHOOOOOOOOOOOOOOOOOOOHXXXX
XXXXXXXHOOOOOOOOOOOOOOOOOOOOOH#X
XXX#OOOOOOOOOOOOOOOOOOOOOOOOOOHH
XX#OOOOOOOOOOOOOOOOOOOOOOOOOOOOO
HHOOOOOOOOOOOOOOOOOOOOOOOOOOOOOO
OOOOOOOOOOOOOOOOOOOOOOOOOOOOOOOO
OOOOOOOOOOOOOOOOOOOOOOOOOOOOOOHX
OOOOOOOOOOOOOOOOOOOOOOOOOOOOO#XX
OOOOOXOOOOOOOOOOOOOOOOOOOOOOOOHX
OOOOXXOOOOOOOOOHHOOOOOOOOOOOOOOO
OOOOOOOOOOOOOOXXXXOOOOOOOOOOOOOO
OOOOOOOOOOOOOOXXXXOOOOOOOOOOOOOO
OOOOOOOOOOOOOOXXXXOOOOOOOOOOOOOO
OOOOOOOOOOOOOOOHHOOOOOOOHOOOOOOO
OOOOOOOOOOOOOOOOOOOOOOOOHXOOOOOO
XOOOOOOOOOOOOOOOOOOOOOOOOXXOOOOO
XXXXOOOOOOOOOOOOOOOOOOOOOXXOOOOO
XXOOOOOOOOOOOOO#OOOOOOOOOOHOOOOO
XOOOOOOOOOOOOOXXOOOOOOOOOOOOXXOO
OOOOOOOOOOOOOOOXOOOOOOOOOOOHX#OO
OOOOOOOOOOOOOOO#OOOOOOOOOOXXXOOO
OOOOOOOOOOOOOOOOOOOOOOOOOO#XXOOO
OOOOOOOOOOOOOOOOOOOOOOOOOOOXOOOO
OOOOOXXXOOOOOOOOOOOOOOOOOOOOOOOO
OOOO#XXX#OOOOOOOOOOOOOOOOOOOOOOO
OOOOOXXXOOOOOOOOOOOOOOOOOOOOOOOO
OOOOOOOOOOOOOOOOOHHOOOOOOOOOOOOO
OOOOOOOOOOOOOOOOOHXXOOOOOOOOOOOO
OOOOOOOOOOOOOOOOOOOOOOOOOOOOOOOO
OOOOOOOOOOOOOOOOOOOOOOOOOOOOOOOO
XOOOOOOOOOOOOOOOOOOOOOOOOOOOOOOX
XX###HHOOOOOOOOOOOOOOOOOOOOO##XX